#############################################
#                                           #
#                                           #
#                                           #
#                                           #
#       ####                     ####       #
#       ####                     ####       #
#                                           #
#                                           #
#                                           #
#                                           #
#                   #####                   #
#                   #####                   #
#                     #                     #
#                     #                     #
#                     #                     #
#                   #####                   #
#                   #####                   #
#                                           #
#                                           #
#                                           #
#                                           #
#       ####                     ####       #
#       ####                     ####       #
#                                           #
#                                           #
#                                           #
#                                           #
#############################################